_XXX____________________________
___X____________________________
___X_____________________XXX____
___X____________________X____X__
___X____________________X____X__
___XXXX_XXXXX________XX_________
____________X________________X__
____________X_______X___________
____________X_______X___________
____________X_______X________X__
____________________X___________
____________X___________________
____________X________________X__
____________X_______X___________
____________X_______X_____XXX___
_________________X_____X________
________________________________
____________X___________________
____________X___X_______X_______
____________X___X__________X____
____________X___X_______________
____________X___X_______________
____________X_____________X_____
____________X__________X________
___XX__XXXXX____X_______________
_X______________X_______________
_X______________X_______________
_X______XXXXXXX_________________
_X_____X________________________
_______X________________________
__XXXX__________________________
________________________________
