_XXX____________________________
___X____________________________
___X____________________XXXXXX__
___X____________________X____X__
___X____________________X____X__
___XXXXXXXXXX_______XXXXX____X__
____________X_______X________X__
____________X_______X________X__
____________X_______X________X__
____________X_______X________X__
____________X_______X________X__
____________X_______X________X__
____________X_______X________X__
____________X_______X________X__
____________X_______X__XXXXXXX__
____________X___XXXXX__X________
____________X___X______X________
____________X___X______X________
____________X___X______XXXXX____
____________X___X__________X____
____________X___X__________X____
____________X___X__________X____
____________X___X______XXXXX____
____________X___X______X________
_XXXXXXXXXXXX___X_______________
_X______________X_______________
_X______________X_______________
_X_____XXXXXXXXXX_______________
_X_____X________________________
_X_____X________________________
_XXXXXXX________________________
________________________________
